10.oX
.....oo.oo
.o....o..o
.ooo..o.oo
.o.o.o...o
o.o.o..ooo
o...o.o.oo
o.oo..oo..
oo..o.oo.o
.o.ooo..o.
.o.ooo..oo