10.oX
....o....o
o..o...o..
o.o.o.....
.oo.......
.....o....
.o...o....
........o.
..o...oo..
.......oo.
..oo......